16 4 4 4 4 4 4 4 4 4 4 4 4 4 4 4 4 17
2 1 1 1 1 1 1 1 1 1 1 1 1 1 1 1 1 3
2 1 1 1 1 1 1 1 1 1 1 1 1 1 1 1 1 3
2 1 1 1 1 1 1 1 1 1 1 1 1 1 1 1 1 3
2 1 1 1 1 1 1 1 1 1 1 1 1 1 1 1 1 3
2 1 1 1 1 1 1 1 1 1 1 1 1 1 1 1 1 3
2 1 1 1 1 1 1 1 1 1 1 1 1 1 1 1 1 3
2 1 1 1 1 1 1 1 1 1 1 1 1 1 1 1 1 3
2 1 1 1 1 1 1 1 1 1 1 1 1 1 1 1 1 3
2 1 1 1 1 1 1 1 1 1 1 1 1 1 1 1 1 3
2 1 1 1 1 1 1 1 1 1 1 1 1 1 1 1 1 3
2 1 1 1 1 1 1 1 1 1 1 1 1 1 1 1 1 3
2 1 1 1 1 1 1 1 1 1 1 1 1 1 1 1 1 3
2 1 1 1 1 1 1 1 1 1 1 1 1 1 1 1 1 3
2 1 1 1 1 1 1 1 1 1 1 1 1 1 1 1 1 3
2 1 1 1 1 1 1 1 1 1 1 1 1 1 1 1 1 3
2 1 1 1 1 1 1 1 1 1 1 1 1 1 1 1 1 3
2 1 1 1 1 1 1 1 1 1 1 1 1 1 1 1 1 3
15 7 7 7 7 7 7 7 7 7 7 7 7 7 7 7 7 14


1 1 1 1 1 1 1 1 1 1 1 1 1 1 1 1 1 1
1 1 1 1 1 1 1 1 1 1 1 1 1 1 1 1 1 1
1 1 1 1 1 1 1 1 1 1 1 1 1 1 1 1 1 10
2 6 7 10 13 0 7 7 6 8 7 7 10 13 0 7 8 1
2 3 1 1 12 1 1 1 3 2 1 1 1 12 1 1 2 1
2 3 1 1 1 1 1 1 5 9 1 1 1 1 1 1 2 1
2 3 1 1 1 1 1 1 1 1 1 1 1 1 1 1 2 1
2 3 1 1 1 1 1 1 1 1 1 1 1 1 1 1 2 1
2 6 7 8 1 1 1 1 1 1 1 1 1 1 6 7 8 1
2 5 4 9 1 1 1 6 7 7 8 1 1 1 5 4 9 1
2 3 1 1 1 1 1 5 4 4 9 1 1 1 1 1 2 1
2 6 7 8 1 1 1 1 1 1 1 1 1 1 6 7 8 1
2 5 4 9 1 1 1 1 1 1 1 1 1 1 5 4 9 1
2 3 1 1 1 1 1 1 1 1 1 1 1 1 1 1 2 1
2 3 1 1 1 1 1 1 6 8 1 1 1 1 1 1 2 1
2 3 1 1 11 1 1 1 3 2 1 1 1 11 1 1 2 1
2 5 4 10 13 0 4 4 5 9 4 4 10 13 0 4 9 1
2 1 1 1 1 1 1 1 1 1 1 1 1 1 1 1 1 1